###############
# *           #
#      @      #
#          b  #
#          b  #
#   aaaaa  b  #
#             #
#             #
#     oooo    #
#     o1oo    #
#     oaeo    #
#     oooo    #
#             #
#       x     #
###############