###############
#     @       #
#             #
#             #
#             #
#             #
#             #
#             #
#             #
#             #
#             #
#           x #
#             #
#             #
###############
