###############
#             #
#      @      #
#  rrrr****   #
#             #
#             #
#oo         oo#
#2o         ov#
#oo         oo#
#             #
#             #
#             #
#             #
#       x     #
###############