###############
#             #
#      @      #
#             #
#             #
#             #
#oo         oo#
#ho         ov#
#oo         oo#
#             #
#             #
#             #
#             #
#       x     #
###############